_____B_B_S_G
_BBB_B___GS_
__BBS_B___B_
_B_B_SB_____
_____BB____B
___BB___B___
B___S______S
S_______B___
B______GBB_S